2 2 2 0 0 0 0 0 0 0 0 0 0 2 2 2
2 2 0 0 0 0 0 0 0 0 0 0 0 0 2 2
2 0 0 0 0 0 0 0 0 0 0 0 0 0 0 2
2 0 0 0 0 0 7 0 0 0 0 0 0 0 0 2
2 0 0 0 0 7 7 7 0 0 0 0 0 0 0 2
2 0 0 0 7 7 7 7 7 0 0 0 0 0 0 2
2 0 0 0 0 7 7 7 0 0 0 0 0 0 0 2
2 0 0 0 0 0 7 0 0 0 0 0 0 0 0 2
2 0 0 0 0 0 0 0 0 0 0 0 0 0 0 2
2 2 0 0 0 0 0 0 0 0 0 0 0 0 2 2
2 2 2 0 0 0 0 0 0 0 0 0 0 2 2 2
2 2 2 2 2 2 5 6 2 2 2 2 2 2 2 2