2 2 2 2 2 2 2 2 2 2 2 2 2 2 2 2 2 2 2 2 2 2 2 2 2 2 2 2 2 2 2 2 2 2 2 2 2 2 2 2 2 2 2 2 2 2 2 2 2 2 2 2 2 2 2 2 2 2 2 2 2 2 2 2 2 2
2 7 7 7 7 7 7 7 7 7 7 7 7 7 7 7 7 7 7 7 7 7 7 7 7 7 7 7 7 7 7 7 7 7 7 7 7 7 7 7 7 7 7 7 7 7 7 7 7 7 7 7 7 7 7 7 7 7 7 7 7 7 7 7 7 7
2 7 7 7 7 7 7 7 7 7 7 7 7 7 7 7 7 7 7 7 7 7 7 7 7 7 7 7 7 7 7 7 7 7 7 7 7 7 7 7 7 7 7 7 7 7 7 7 7 7 7 7 7 7 7 7 7 7 7 7 7 7 7 7 7 7
2 7 7 7 7 7 7 7 7 7 7 7 7 7 7 7 7 7 7 7 7 7 7 7 7 7 7 7 7 7 7 7 7 7 7 7 7 7 7 7 7 7 7 7 7 7 7 7 7 7 7 7 7 7 7 7 7 7 7 7 7 7 7 7 7 7
2 7 7 7 7 7 7 7 7 7 7 7 7 7 7 7 7 7 7 7 7 7 7 7 7 7 7 7 7 7 7 7 7 7 7 7 7 7 7 7 7 7 7 7 7 7 7 7 7 7 7 7 7 7 7 7 7 7 7 7 7 7 7 7 7 7
2 7 7 7 7 7 7 7 7 7 7 7 7 7 7 7 7 7 7 7 7 7 7 7 7 7 7 7 7 7 7 7 7 7 7 7 7 7 7 7 7 7 7 7 7 7 7 7 7 7 7 7 7 7 7 7 7 7 7 7 7 7 7 7 7 7
2 7 7 7 7 7 2 7 7 7 7 7 2 2 2 7 7 7 7 7 7 7 7 7 7 7 7 7 7 7 0 7 7 7 7 7 7 7 7 7 7 7 7 7 7 7 7 7 7 7 7 7 7 4 4 4 2 2 2 2 2 2 2 2 2 2
2 7 7 7 7 7 2 7 0 0 0 0 0 7 0 0 0 0 0 0 0 2 2 7 7 7 7 7 7 7 1 7 7 7 7 7 7 0 7 7 7 7 7 7 7 7 7 7 7 7 7 7 7 4 3 4 2 2 2 2 2 2 2 2 2 2
2 7 7 7 7 7 2 7 7 7 0 0 0 7 0 7 0 0 0 0 0 2 2 7 7 7 7 7 7 7 1 1 1 1 0 0 1 0 1 0 7 7 7 7 7 7 7 7 7 7 7 7 7 4 3 4 2 2 2 2 2 2 2 2 2 2
2 7 7 7 7 7 2 7 7 7 0 0 0 7 1 7 0 0 0 0 0 2 2 7 7 7 7 7 7 7 1 7 7 7 7 7 7 0 7 1 7 7 7 7 7 7 7 7 7 7 7 7 7 4 3 4 2 2 2 2 2 2 2 2 2 2
2 7 7 7 7 7 2 7 0 0 0 0 0 7 1 7 0 0 0 0 0 2 2 7 7 7 7 7 7 7 1 7 7 7 7 7 7 7 7 1 7 7 7 7 7 7 7 7 7 7 7 7 7 4 3 4 2 2 2 2 2 2 2 2 2 2
2 7 7 7 7 7 2 7 0 0 0 0 0 7 0 7 0 0 0 0 0 2 2 7 7 7 7 7 7 7 1 7 7 7 7 7 7 7 7 0 7 7 7 7 7 7 7 7 7 7 7 7 7 4 3 4 2 2 2 2 2 2 2 2 2 2
2 7 7 7 7 7 2 7 0 0 0 0 0 7 1 7 0 0 0 0 0 2 2 7 7 7 7 7 7 7 1 7 7 7 7 7 7 7 7 1 7 7 7 7 7 7 7 7 7 7 4 4 4 4 3 4 2 2 2 2 2 2 2 2 2 2
2 7 7 7 7 7 2 7 0 0 7 0 0 7 0 7 0 0 0 0 2 2 2 4 4 4 4 4 4 4 3 4 4 4 4 4 4 4 4 3 4 4 4 4 4 4 4 4 4 4 4 3 3 3 3 4 2 2 2 2 2 2 2 2 2 2
2 7 7 7 7 7 2 7 2 2 0 0 0 7 1 0 0 0 0 2 2 2 2 4 7 7 7 7 7 7 3 7 7 7 7 7 7 7 7 3 7 7 4 4 4 4 4 4 4 4 3 3 3 3 3 4 2 2 2 2 2 2 2 2 2 2
2 7 7 7 7 7 2 7 2 2 0 0 0 7 1 7 0 0 0 0 0 7 0 4 7 3 3 3 3 3 3 3 3 3 3 3 3 3 3 3 3 7 4 4 4 4 4 4 4 3 3 3 3 3 3 4 2 2 2 2 2 2 2 2 2 2
2 7 7 7 7 7 2 7 0 0 0 0 7 7 0 7 0 0 0 0 0 7 7 4 7 3 3 3 3 3 3 3 3 3 3 3 3 3 3 3 3 7 4 4 4 4 4 4 3 3 3 3 3 3 3 4 2 2 2 2 2 2 2 2 2 2
2 7 7 7 7 7 2 7 0 7 7 7 7 7 0 7 7 7 7 7 7 7 7 4 7 3 3 3 3 3 3 3 3 3 3 3 3 3 3 3 3 7 4 4 4 4 4 3 3 3 3 3 3 3 3 4 2 2 2 2 2 2 2 2 2 2
2 7 7 7 7 7 2 7 0 0 1 1 0 1 1 0 1 0 1 1 0 1 1 3 3 3 3 3 3 3 3 3 3 3 3 3 3 3 3 3 3 7 4 4 4 4 3 3 3 3 3 3 3 3 3 4 2 2 2 2 2 2 2 2 2 2
2 7 7 7 7 7 2 7 7 7 7 7 7 7 1 7 7 7 7 7 7 7 7 4 7 3 3 3 3 3 3 3 3 3 3 3 3 3 3 3 3 1 1 1 1 3 3 3 3 3 3 3 3 3 3 4 2 2 2 2 2 2 2 2 2 2
2 7 7 7 7 7 2 7 0 0 0 0 7 0 1 0 0 0 0 0 0 7 7 4 7 3 3 3 3 3 3 3 3 3 3 3 3 3 3 3 3 7 4 4 4 4 3 3 3 3 3 3 3 3 3 4 2 2 2 2 2 2 2 2 2 2
2 7 7 7 7 7 2 7 0 0 0 0 0 0 0 0 0 0 0 0 0 7 7 4 7 3 3 3 3 3 3 3 3 3 3 3 3 3 3 3 3 7 4 4 4 4 4 3 3 3 3 3 3 3 3 4 2 2 2 2 2 2 2 2 2 2
2 7 7 7 7 7 2 7 0 0 0 0 0 0 1 0 0 0 0 0 0 7 7 4 7 3 3 3 3 3 3 3 3 3 3 3 3 3 3 3 3 7 4 4 4 4 4 4 3 3 3 3 3 3 3 4 2 2 2 2 2 2 2 2 2 2
2 7 7 7 7 7 2 7 0 0 0 0 0 0 1 0 0 0 0 0 0 7 0 4 7 3 3 3 3 3 3 3 3 3 3 3 3 3 3 3 3 7 4 4 4 4 4 4 4 3 3 3 3 3 3 4 2 2 2 2 2 2 2 2 2 2
2 7 7 7 7 7 2 7 0 0 0 0 0 0 0 0 0 0 0 0 0 7 7 4 7 3 3 3 3 3 3 3 3 3 3 3 3 3 3 3 3 7 4 4 4 4 4 4 4 4 3 3 3 3 3 4 2 2 2 2 2 2 2 2 2 2
2 7 7 7 7 7 2 7 0 0 0 0 0 0 1 0 0 0 0 0 0 7 7 4 7 7 7 7 7 7 7 7 7 7 7 7 7 7 7 7 3 0 1 1 0 0 0 0 0 0 4 3 3 3 3 4 2 2 2 2 2 2 2 2 2 2
2 7 7 7 7 7 2 7 0 0 0 0 0 0 1 0 0 0 0 0 0 7 1 4 4 4 4 4 4 4 4 4 4 4 4 4 4 4 4 4 4 4 4 4 4 4 4 4 4 0 4 3 3 3 3 4 2 2 2 2 2 2 2 2 2 2
2 7 7 7 7 7 2 7 0 0 0 0 0 0 0 0 0 0 0 0 0 7 1 7 7 7 7 7 7 7 7 7 7 7 7 7 7 7 7 7 7 7 7 7 7 7 7 7 7 0 4 4 4 4 3 4 2 2 2 2 2 2 2 2 2 2
2 7 7 7 7 7 2 7 0 0 0 0 0 0 1 0 0 0 0 0 0 7 1 7 7 7 7 7 7 7 7 7 7 7 7 7 7 7 7 7 7 7 7 7 7 7 7 7 7 0 7 7 7 4 3 4 2 2 2 2 2 2 2 2 2 2
2 7 7 7 7 7 2 7 0 0 0 0 0 0 0 0 0 0 0 0 0 7 1 7 7 7 7 7 7 7 7 7 7 7 7 7 7 7 7 7 7 7 7 7 7 7 7 7 7 0 7 7 7 4 3 4 2 2 2 2 2 2 2 2 2 2
2 7 7 7 7 7 2 7 0 0 0 0 0 0 1 0 0 0 0 0 0 7 0 7 7 7 7 7 7 7 7 7 7 7 7 7 7 7 7 7 7 7 7 7 7 7 7 7 7 0 7 7 7 4 3 4 2 2 2 2 2 2 2 2 2 2
2 7 7 7 7 7 2 7 0 0 0 0 0 0 0 0 0 0 0 0 7 7 0 7 7 7 7 7 7 7 7 7 7 7 7 7 7 7 7 7 7 7 7 7 7 7 7 7 7 0 7 7 7 4 3 2 2 2 2 2 2 2 2 2 2 2
2 7 7 7 7 7 2 7 7 0 0 0 0 0 1 0 0 0 0 0 1 1 0 7 7 7 7 7 7 7 7 7 7 7 7 7 7 7 7 7 7 7 7 7 7 7 7 7 7 0 7 7 7 4 3 2 2 2 2 2 2 2 2 2 2 2
2 7 7 7 7 7 2 7 7 7 0 0 0 0 1 0 0 0 7 7 7 7 1 7 7 7 7 7 7 7 7 7 7 7 7 7 7 7 7 7 7 7 7 7 7 7 7 7 7 0 7 7 7 4 3 2 2 2 2 2 2 2 2 2 2 2
2 7 7 7 7 7 2 7 7 7 7 0 0 0 0 0 0 7 7 7 7 7 1 7 7 7 7 7 7 7 7 7 7 7 7 7 7 7 7 7 7 7 7 7 7 7 7 7 7 0 7 7 7 4 3 2 2 2 2 2 2 2 2 2 2 2
2 7 7 7 7 7 2 7 7 7 7 7 0 0 2 0 7 7 7 7 7 7 1 7 7 7 7 7 7 7 7 7 7 7 7 7 7 7 7 7 7 7 7 7 7 7 7 7 7 0 0 0 1 3 3 2 2 2 2 2 2 2 2 2 2 2
2 7 7 7 7 7 2 7 7 7 7 7 7 7 7 7 7 7 7 7 7 7 1 1 1 1 1 1 1 1 0 0 0 0 0 1 0 1 0 0 0 1 1 1 0 0 1 0 1 1 7 7 7 7 2 2 2 2 2 2 2 2 2 2 2 2
2 2 2 2 2 2 2 2 2 2 2 2 2 2 2 2 2 2 2 2 2 2 3 7 7 7 7 7 7 7 7 7 7 7 7 7 7 7 7 7 7 7 7 7 7 7 7 7 7 7 7 7 7 2 2 2 2 2 2 2 2 2 2 2 2 2
2 2 2 2 2 2 2 2 2 2 2 2 2 2 2 2 2 2 2 2 2 2 2 2 2 2 2 2 2 2 2 2 2 2 2 2 2 2 2 2 2 2 2 2 2 2 2 2 2 2 2 2 2 2 2 2 2 2 2 2 2 2 2 2 2 2
2 2 2 2 2 2 2 2 2 2 2 2 2 2 2 2 2 2 2 2 2 2 5 6 2 2 2 2 2 2 2 2 2 2 2 2 2 2 2 2 2 2 2 2 2 2 2 2 2 2 2 2 2 2 2 2 2 2 2 2 2 2 2 2 2 2
2 2 2 2 2 2 2 2 2 2 2 2 2 2 2 2 2 2 2 2 2 2 2 2 2 2 2 2 2 2 2 2 2 2 2 2 2 2 2 2 2 2 2 2 2 2 2 2 2 2 2 2 2 2 2 2 2 2 2 2 2 2 2 2 2 2
2 2 2 2 2 2 2 2 2 2 2 2 2 2 2 2 2 2 2 2 2 2 2 2 2 2 2 2 2 2 2 2 2 2 2 2 2 2 2 2 2 2 2 2 2 2 2 2 2 2 2 2 2 2 2 2 2 2 2 2 2 2 2 2 2 2
2 2 2 2 2 2 2 2 2 2 2 2 2 2 2 2 2 2 2 2 2 2 2 2 2 2 2 2 2 2 2 2 2 2 2 2 2 2 2 2 2 2 2 2 2 2 2 2 2 2 2 2 2 2 2 2 2 2 2 2 2 2 2 2 2 2
2 2 2 2 2 2 2 2 2 2 2 2 2 2 2 2 2 2 2 2 2 2 2 2 2 2 2 2 2 2 2 2 2 2 2 2 2 2 2 2 2 2 2 2 2 2 2 2 2 2 2 2 2 2 2 2 2 2 2 2 2 2 2 2 2 2
2 2 2 2 2 2 2 2 2 2 2 2 2 2 2 2 2 2 2 2 2 2 2 2 2 2 2 2 2 2 2 2 2 2 2 2 2 2 2 2 2 2 2 2 2 2 2 2 2 2 2 2 2 2 2 2 2 2 2 2 2 2 2 2 2 2
2 2 2 2 2 2 2 2 2 2 2 2 2 2 2 2 2 2 2 2 2 2 2 2 2 2 2 2 2 2 2 2 2 2 2 2 2 2 2 2 2 2 2 2 2 2 2 2 2 2 2 2 2 2 2 2 2 2 2 2 2 2 2 2 2 2